背景 背景 背景 背景 背景 背景 背景 背景 背景
背景 背景 背景 背景 背景 背景 背景 背景 背景
背景 背景 电脑 沙发 水壶 地板 地板 背景 背景
背景 背景 地板 地板 地板 地板 地板 背景 背景 
背景 背景 地板 衣架 地板 地板 出口 背景 背景
背景 背景 地板 地板 地板 地板 地板 背景 背景 
背景 背景 书包 地板 地板 地板 地板 背景 背景
背景 背景 背景 背景 背景 背景 背景 背景 背景
背景 背景 背景 背景 背景 背景 背景 背景 背景
