墙 墙 墙 墙 墙 墙 墙 墙 墙 墙 墙 墙 墙 墙 墙 墙 墙 墙 墙 墙 墙 墙 墙 墙 墙 墙 墙 墙 墙 墙 墙 墙 墙 墙 墙 墙
墙 墙 墙 墙 墙 墙 墙 墙 墙 墙 墙 墙 墙 墙 墙 墙 墙 墙 墙 墙 墙 墙 墙 墙 墙 墙 墙 墙 墙 墙 墙 墙 墙 墙 墙 墙
墙 墙 树 树 树 树 树 树 树 树 树 树 树 树 树 树 树 树 路 路 树 树 树 树 树 树 树 树 树 树 树 树 树 树 墙 墙
墙 墙 草 草 草 草 草 草 草 树 草 草 草 草 草 草 草 草 路 草 草 草 树 草 草 草 草 草 草 草 草 草 草 草 墙 墙
墙 墙 草 路 草 路 路 路 路 路 路 路 路 路 路 路 路 路 路 路 路 路 路 路 路 路 路 路 路 路 路 路 路 路 墙 墙
墙 墙 草 路 草 树 树 树 草 树 树 路 树 树 树 路 树 树 树 树 路 树 树 路 路 路 路 路 树 树 树 树 树 树 墙 墙
墙 墙 训 路 草 树 树 树 草 树 树 路 树 树 树 路 树 树 树 树 路 树 树 树 树 树 路 树 树 树 树 树 树 树 墙 墙
墙 墙 草 路 草 树 树 树 草 树 树 路 路 树 树 路 树 树 树 树 路 树 树 树 树 树 路 树 树 树 树 树 树 树 墙 墙
墙 墙 草 路 草 树 树 树 草 树 树 树 路 树 树 路 树 树 树 树 路 树 树 商 路 路 路 树 树 树 树 树 树 树 墙 墙                
墙 墙 草 路 路 路 路 路 路 路 路 路 路 路 路 路 路 路 路 路 路 路 路 路 路 家 路 路 路 路 树 树 树 树 墙 墙
墙 墙 草 路 路 路 树 路 路 树 树 树 路 树 树 路 树 树 树 树 路 树 美 树 树 路 路 树 树 路 树 树 树 树 墙 墙
墙 墙 草 路 路 树 树 树 路 路 树 树 路 树 树 路 路 树 树 树 路 树 树 树 树 树 路 树 树 路 树 树 树 树 墙 墙
墙 墙 草 路 草 树 树 树 树 路 树 树 路 树 树 树 路 树 树 树 路 路 树 树 树 树 路 树 树 路 草 树 树 树 墙 墙
墙 墙 训 路 草 树 路 路 树 路 路 树 路 树 树 树 路 树 树 树 路 树 树 树 树 树 路 树 树 草 树 草 树 树 墙 墙
墙 墙 草 路 草 树 路 树 树 树 路 树 路 树 树 树 路 树 树 树 路 树 树 树 树 树 路 树 树 草 树 草 树 树 墙 墙
墙 墙 草 路 草 树 路 树 树 树 路 树 路 树 树 树 路 树 树 树 路 树 树 树 树 树 路 树 树 草 树 树 树 树 墙 墙
墙 墙 草 路 草 树 路 树 树 树 路 树 路 树 树 树 路 树 树 树 路 树 树 树 树 树 路 树 树 草 草 树 树 树 墙 墙
墙 墙 草 路 草 树 路 树 树 树 路 树 路 树 树 树 路 树 树 树 路 路 树 树 树 树 路 树 树 树 树 树 树 树 墙 墙
墙 墙 草 路 草 路 路 路 路 路 路 路 路 路 路 路 路 路 路 路 路 路 路 路 路 路 路 路 路 路 路 路 路 路 墙 墙
墙 墙 草 路 草 草 训 草 草 草 草 草 草 草 草 草 草 草 草 草 草 草 草 草 草 训 草 草 草 草 草 草 草 草 墙 墙
墙 墙 墙 墙 墙 墙 墙 墙 墙 墙 墙 墙 墙 墙 墙 墙 墙 墙 墙 墙 墙 墙 墙 墙 墙 墙 墙 墙 墙 墙 墙 墙 墙 墙 墙 墙
墙 墙 墙 墙 墙 墙 墙 墙 墙 墙 墙 墙 墙 墙 墙 墙 墙 墙 墙 墙 墙 墙 墙 墙 墙 墙 墙 墙 墙 墙 墙 墙 墙 墙 墙 墙
