背景 背景 背景 背景 背景 背景 背景 背景 背景 背景 背景
背景 背景 背景 背景 背景 背景 背景 背景 背景 背景 背景
背景 背景 桌子 地板 地板 地板 地板 地板 地板 背景 背景 
背景 背景 桌子 地板 茶几 行人 地板 地板 地板 背景 背景
背景 背景 桌子 地板 茶几 行人 地板 地板 地板 背景 背景 
背景 背景 桌子 地板 地板 地板 地板 地板 出口 背景 背景          
背景 背景 售台 地板 地板 地板 桌子 地板 地板 背景 背景            
背景 背景 桌子 地板 地板 地板 地板 地板 地板 背景 背景
背景 背景 桌子 地板 茶几 地板 地板 地板 地板 背景 背景
背景 背景 桌子 地板 茶几 地板 地板 地板 地板 背景 背景
背景 背景 桌子 地板 地板 地板 地板 地板 地板 背景 背景
背景 背景 背景 背景 背景 背景 背景 背景 背景 背景 背景
背景 背景 背景 背景 背景 背景 背景 背景 背景 背景 背景
